2
(0,7);(7,7)
(0,0);(7,0)
g m w m m g g g
g m w m g g g g
g g w w g w w w
g g g w g w g w
g g g w w w g g
g g g g g d d g
g g g d d d d d
g g g g d d d d